10 10
S#########
####T##X##
#M#####X##
#######X##
####XXXX##
#X########
#X######C#
#XXX##F###
##########
######B###

# Will create a map with 10x10 size
# * * * * * * * * * * * *
# * S                   *
# *         T     X     *
# *   M           X     *
# *               X     *
# *         X X X X     *
# *   X                 *
# *   X              C  *
# *   X X X     F       *
# *                     *
# *             B       *
# * * * * * * * * * * * *
